----------------------------------------------
----------------------------------------------
----------------------------------------------
----------------------------------------------
----------------------------------------------
----------------------------------------------
----------------------------------------------
----------------------------------------------
-------------gllllllllllllllllllh-------------
-------------opnnnnnnnnnnnnnnnnpm-------------
-------------om0******#********om-------------
-------------om*ce*a*a*a*a*a*a*om-------------
-------------om**#************#pm-------------
-------------om*ce*a*a*a*a*a*a*om-------------
-------------om******#*****#***om-------------
-------------om*a*a*a*a*a*a*ce*om-------------
-------------om***#*152*****#**om-------------
-------------opllllllllllllllllpm-------------
-------------fnnnnnnnnnnnnnnnnnni-------------
----------------------------------------------
----------------------------------------------
----------------------------------------------
----------------------------------------------
----------------------------------------------
