----------------------------------------------
----------------------------------------------
----------------------------------------------
----------------------------------------------
--------gllllllllllllllllllllllllllllh--------
--------opnnnnnnnnnnnnnnnnnnnnnnnnnnpm--------
--------om0*************************om--------
--------om*a*a*a*a*a*a*a*a*a*a*a*ce*om--------
--------om*************************#om--------
--------om*ce*a*a*a*a*a*a*a*a*a*a*a*om--------
--------om**************************om--------
--------om*a*a*a*a*a*a*a*a*a*a*a*ce*om--------
--------om********#*****************om--------
--------om*ce*a*a*a*a*a*a*a*a*a*a*a*om--------
--------om*************************#pm--------
--------om*ce*a*a*a*a*a*a*a*a*a*a*a*om--------
--------om**************************om--------
--------om*a*a*a*a*a*a*a*a*a*a*a*ce*om--------
--------om***************12345******om--------
--------opllllllllllllllllllllllllllpm--------
--------fnnnnnnnnnnnnnnnnnnnnnnnnnnnni--------
----------------------------------------------
----------------------------------------------
----------------------------------------------
