----------------------------------------------
----------------------------------------------
----------------------------------------------
----------------------------------------------
----------------------------------------------
---------gkkkkkkkkkkkkkkkkkkkkkkkkkkh---------
---------j0*************************j---------
---------j*a#ch-a-ckkh-d-cke-d-gllh-j---------
---------j****b------b-b-----b-fnni-j---------
---------j*ce---ckkh----ckke---1----j---------
---------j---------b-ce------a-ckke-j---------
---------j-d------------------------j---------
---------j-j----------5-------------j---------
---------j-j------------------------j---------
---------j-b----------------4-------j---------
---------j--------------------------j---------
---------j-gkke-ch------------------j---------
---------j-j2----j------------------j---------
---------j-b-a-a-b------------------j---------
---------j------------------3-------j---------
---------fkkkkkkkkkkkkkkkkkkkkkkkkkki---------
----------------------------------------------
----------------------------------------------
----------------------------------------------
----------------------------------------------
----------------------------------------------