----------------------------------------------
----------------------------------------------
----------------------------------------------
----------------------------------------------
----------------------------------------------
----------------------------------------------
----------------------------------------------
----------------------------------------------
-------------gllllllllllllllllllh-------------
-------------opnnnnnnnnnnnnnnnnpm-------------
-------------om0******#********om-------------
-------------om*ce*cke*a*a*a*a*om-------------
-------------om**#************#om-------------
-------------om*ce*a*a*a*cke*a*om-------------
-------------om************#***om-------------
-------------om*a*a*cke*a*a*ce*om-------------
-------------om***#*152*****#**om-------------
-------------opllllllllllllllllpm-------------
-------------fnnnnnnnnnnnnnnnnnni-------------
----------------------------------------------
----------------------------------------------
----------------------------------------------
----------------------------------------------
----------------------------------------------
