----------------------------------------------
----------------------------------------------
----------------------------------------------
----------------------------------------------
----------------------------------------------
----------------------------------------------
----------------------------------------------
----------------------------------------------
-------------gllllllllllllllllllh-------------
-------------opnnnnnnnnnnnnnnnnpm-------------
-------------om0******#***3**1*om-------------
-------------om*ce*cke*a*cke*a*om-------------
-------------om**#************#om-------------
-------------om*ce*cke*a*cke*a*om-------------
-------------om************#***om-------------
-------------om*a*a*cke*a*a*ce*om-------------
-------------om***#**5******#**om-------------
-------------opllllllllllllllllpm-------------
-------------fnnnnnnnnnnnnnnnnnni-------------
----------------------------------------------
----------------------------------------------
----------------------------------------------
----------------------------------------------
----------------------------------------------
