----------------------------------------------
----------------------------------------------
----------------------------------------------
----------------------------------------------
----------------------------------------------
---------gkkkkkkkkkkkkkkkkkkkkkkkkkkh---------
---------j0*-----------------4------j---------
---------j*a-ce-a-ce-d-a-cke-d-gllh-j---------
---------j-----------b-------b-fnni-j---------
---------j-ce-a-ckke---a-cke---1----j---------
---------j-----------d-------a-ckke-j---------
---------j-d-ce-a-ce-b-ckkke--------j---------
---------j-j----------5------a-a-ce-j---------
---------j-j-gh-d-gh-d-d-cke--------j---------
---------j-j-fi-b-fi-b-b------a-cke-j---------
---------j-b-------------ckke-------j---------
---------j---ce-ce-d-cke------d-cke-j---------
---------j-d2------j-----gllh-j-----j---------
---------j-b-a-a-a-b-cke-fnni-b-cke-j---------
---------j------------------3-------j---------
---------fkkkkkkkkkkkkkkkkkkkkkkkkkki---------
----------------------------------------------
----------------------------------------------
----------------------------------------------
----------------------------------------------
----------------------------------------------
