----------------------------------------------
----------------------------------------------
----------------------------------------------
----------------------------------------------
----------------------------------------------
----------------------------------------------
----------------------------------------------
----------------------------------------------
-------------gllllllllllllllllllh-------------
-------------opnnnnnnnnnnnnnnnnpm-------------
-------------om0#*********3**1*om-------------
-------------om*ce*a*a*a*cke*a*om-------------
-------------om*******#*******#pm-------------
-------------om*ce*cke*a*cke*d*om-------------
-------------om*#**********#*j*om-------------
-------------om*a*a*cke*a*a*ci*om-------------
-------------om******5******#**om-------------
-------------opllllllllllllllllpm-------------
-------------fnnnnnnnnnnnnnnnnnni-------------
----------------------------------------------
----------------------------------------------
----------------------------------------------
----------------------------------------------
----------------------------------------------
