----------------------------------------------
----------------------------------------------
----------------------------------------------
----------------------------------------------
----------------------------------------------
----------------------------------------------
----------------------------------------------
----------------------------------------------
-----------gllllllllllllllllllllllh-----------
-----------opnnnnnnnnnnnnnnnnnnnnpm-----------
-----------om0#****************1*om-----------
-----------om*ce*cke*a*a*cke*a*d*om-----------
-----------om*********#*******#b*om-----------
-----------om*gke*ckke*a*cke*d***om-----------
-----------om*j****4*******#*j*d*om-----------
-----------om*b*a*cke*a*cke*ci*b*om-----------
-----------om******5********#****om-----------
-----------opllllllllllllllllllllpm-----------
-----------fnnnnnnnnnnnnnnnnnnnnnni-----------
----------------------------------------------
----------------------------------------------
----------------------------------------------
----------------------------------------------
----------------------------------------------
