----------------------------------------------
----------------------------------------------
----------------------------------------------
----------------------------------------------
----------------------------------------------
----------------------------------------------
----------------------------------------------
-----------gllllllllllllllllllllllh-----------
-----------opnnnnnnpnnnnnnnnnnnnnpm-----------
-----------om0#****b***2*******1*om-----------
-----------om*ce*a***a*a*ce*a*ch*om-----------
-----------om******d**#*******#b*pm-----------
-----------om*a*d*ci*a*cke*a*d***om-----------
-----------om***b*****#******b#a*om-----------
-----------opke***ckke*a*cke*****om-----------
-----------om***d**4*******#*d*d*om-----------
-----------om*a*b*cke*d*cke*ci*b*om-----------
-----------om******5**j*****#****om-----------
-----------oplllllllllpllllllllllpm-----------
-----------fnnnnnnnnnnnnnnnnnnnnnni-----------
----------------------------------------------
----------------------------------------------
----------------------------------------------
----------------------------------------------
