----------------------------------------------
----------------------------------------------
----------------------------------------------
----------------------------------------------
----------------------------------------------
---------gkkkkkkkkkkkkkkkkkkkkkkkkkkh---------
-0-------a1*-**********************-j---------
---------jaaaaaaaaaaaaaaaaaaaaagllhaj---------
---------j****b------b-b-----b-fnni-j---------
---------j*ce-aackkha---ckke-a----a-j---------
---------j---------b-ce------aackke-j---------
---------j-d------------------------j---------
---------j-j------------------------j---------
---------j-j------------------------j---------
---------j-b------------------------j---------
---------j--------------------------j---------
---------j-gkke-ch------------------j---------
---------j-j-----j------------------j---------
---------j-b-a-a-b------------------j---------
---------j--------------------------j---------
---------fkkkkkkkkkkkkkkkkkkkkkkkkkki---------
----------------------------------------------
----------------------------------------------
----------------------------------------------
----------------------------------------------
----------------------------------------------
