----------------------------------------------
----------------------------------------------
----------------------------------------------
----------------------------------------------
----------------------------------------------
----------------------------------------------
----------------------------------------------
-----------gllllllllllllllllllllllh-----------
-----------opnnnnnnpnnnnnnnnnnnnnpm-----------
-----------om0#****b***3*******1*om-----------
-----------om*ge*a***cke*ce*a*ch*om-----------
-----------om*b****d**#*******#b*om-----------
-----------om***d*ci*a*cke*a*d***om-----------
-----------om*cki*****#******b#a*pm-----------
-----------om*****ckke*a*cke*****om-----------
-----------om*ch*a*4*******#*d*d*om-----------
-----------om**b***ce*d*cke*ci*b*om-----------
-----------oph***d*5**j*****#****om-----------
-----------opplllpllllpllllllllllpm-----------
-----------fnnnnnnnnnnnnnnnnnnnnnni-----------
----------------------------------------------
----------------------------------------------
----------------------------------------------
----------------------------------------------
