----------------------------------------------
----------------------------------------------
----------------------------------------------
----------------------------------------------
----------------------------------------------
----------------------------------------------
----------------------------------------------
-----------gllllllllllllllllllllllh-----------
-----------opnnnnnnpnnnnnnnnnnnnnpm-----------
-----------om0#****b***2*******1*om-----------
-----------om*ce*a***a*a*cke*ckh*om-----------
-----------om******d**#*******#b*pm-----------
-----------om*ce*cki*a*a*cke*a***om-----------
-----------om*********#*******#a*om-----------
-----------om*gke*ckke*a*cke*d***om-----------
-----------om*j****4*******#*j*d*om-----------
-----------om*b*a*cke*a*cke*ci*b*om-----------
-----------om******5********#****om-----------
-----------opllllllllllllllllllllpm-----------
-----------fnnnnnnnnnnnnnnnnnnnnnni-----------
----------------------------------------------
----------------------------------------------
----------------------------------------------
----------------------------------------------
