----------------------------------------------
----------------------------------------------
----------------------------------------------
----------------------------------------------
----------------------------------------------
----------------------------------------------
----------------------------------------------
-----------gllllllllllllllllllllllh-----------
-----------opnnnnnnpnnnnnnnnnnnnnpm-----------
-----------om0#****b***3*******1*om-----------
-----------om*ge*a***cke*ce*a*ch*om-----------
-----------om*j****d**#*******#b*pm-----------
-----------om*b*a*ci*a*cke*a*d***om-----------
-----------om*********#******b#a*om-----------
-----------om*d*a*ckke*a*cke*****om-----------
-----------om*j****4*******#*d*d*om-----------
-----------om*b*a*cke*d*cke*ci*b*om-----------
-----------om******5**j*****#****om-----------
-----------oplllllllllpllllllllllpm-----------
-----------fnnnnnnnnnnnnnnnnnnnnnni-----------
----------------------------------------------
----------------------------------------------
----------------------------------------------
----------------------------------------------
