----------------------------------------------
----------------------------------------------
----------------------------------------------
----------------------------------------------
----------------------------------------------
----------------------------------------------
----------------------------------------------
-----------gllllllllllllllllllllllh-----------
-----------opnnnnnnpnnnnnnnnnnnnnpm-----------
-----------om0#****b***3*******1*om-----------
-----------om*ce*a***cke*ce*a*ch*om-----------
-----------om******d**#*******#b*pm-----------
-----------om*a*a*ci*a*cke*a*d***om-----------
-----------om*********#******b#ckpm-----------
-----------om*cke*a*ce*a*cke*****om-----------
-----------om******4*******#*d*d*om-----------
-----------ope*ce*cke*d*cke*ci*b*om-----------
-----------om******5**j*****#****om-----------
-----------oplllllllllpllllllllllpm-----------
-----------fnnnnnnnnnnnnnnnnnnnnnni-----------
----------------------------------------------
----------------------------------------------
----------------------------------------------
----------------------------------------------
