----------------------------------------------
----------------------------------------------
----------------------------------------------
----------------------------------------------
----------------------------------------------
----------------------------------------------
----------------------------------------------
-----------gllllllllllllllllllllllh-----------
-----------opnnnnnnpnnnnnnnnnnnnnpm-----------
-----------om0#****b***3*******1*om-----------
-----------om*d*gh***cke*ce*a*ch*om-----------
-----------om*b*fi*d**#*******#b*pm-----------
-----------om#*****b*a*cke*a*d***om-----------
-----------om*gh*d****#******b#d*pm-----------
-----------om*fi*fe*ce*a*cke***b*om-----------
-----------om******4*******#*d***om-----------
-----------ope*ce*cke*a*cke*ci*a*om-----------
-----------om******5********#****om-----------
-----------oplllllllllpllllllllllpm-----------
-----------fnnnnnnnnnnnnnnnnnnnnnni-----------
----------------------------------------------
----------------------------------------------
----------------------------------------------
----------------------------------------------
