----------------------------------------------
----------------------------------------------
----------------------------------------------
----------------------------------------------
--------gllllllllllllllllllllllllllllh--------
--------opnnnnnnppnnnnnnnnnnnnnnpnnnpm--------
--------om0**#**fi*****4********j***om--------
--------om*ce*a****d*ce*a*cle*a*b*a*om--------
--------om******a*cm*******b******#*om--------
--------opke#gke***b*d*gh*a**ce*a*ckpm--------
--------om***b***a***b*fi***d*******om--------
--------om*d**2d**ce******gki*ce*gh*om--------
--------om*j*a*fh****gh*a*b******fi*om--------
--------om*b****b*gh*fi*#***a*ce****om--------
--------om**#gh***oi***ckkh*****5ce*om--------
--------oplh*oi*a*b**a****b*ge*a****om--------
--------opni*b*****a***gh***b***a*ckpm--------
--------om*****d*d**ge*fplh1**d**3**om--------
--------om*a*d*b*fe*b***fni*cki*d*a*om--------
--------om**#j****#***d*********j**#om--------
--------oplllpllllllllplllllllllplllpm--------
--------fnnnnnnnnnnnnnnnnnnnnnnnnnnnni--------
----------------------------------------------
----------------------------------------------
----------------------------------------------
