----------------------------------------------
----------------------------------------------
----------------------------------------------
----------------------------------------------
--------gllllllllllllllllllllllllllllh--------
--------opnnnnnnnnnnnnnnnnnnnnnnnnnnpm--------
--------om0*************************om--------
--------om--------------------------om--------
--------om--------------------------om--------
--------om--------------------------om--------
--------om--------------------------om--------
--------om--------------------------om--------
--------om--------------------------om--------
--------om--------------------------om--------
--------om--------------------------om--------
--------om--------------------------pm--------
--------om--------------------------pm--------
--------om--------------------------om--------
--------om--------------------------om--------
--------om--------------------------om--------
--------opllllllllllllllllllllllllllpm--------
--------fnnnnnnnnnnnnnnnnnnnnnnnnnnnni--------
----------------------------------------------
----------------------------------------------
----------------------------------------------
----------------------------------------------

