gllllllllllllllllllllllllllllllllllllllllllllh
opnnnnnnnnnnnnnnnnnnnnnnnnnnnnnnnnnnnnnnnnnnpm
om0-----------------------------------------om
om------------------------------------------om
om------gllllllllllllllllllllllllllllh------om
om------opnnnnnnnnnnnnnnnnnnnnnnnnnnpm------om
om------om**************************om------om
om------om--------------------------om------om
om------om--------------------------om------om
om------om--------------------------om------om
om------om--------------------------om------om
om------om--------------------------om------om
om------om--------------------------om------om
om------om--------------------------om------om
om------om--------------------------om------om
om------om--------------------------pm------om
om------om--------------------------pm------om
om------om--------------------------om------om
om------om--------------------------om------om
om------om--------------------------om------om
om------opllllllllllllllllllllllllllpm------om
om------fnnnnnnnnnnnnnnnnnnnnnnnnnnnni------om
om------------------------------------------om
opllllllllllllllllllllllllllllllllllllllllllpm
fnnnnnnnnnnnnnnnnnnnnnnnnnnnnnnnnnnnnnnnnnnnni